abate	abates	abating	abated
abhorrent
abode	abodes
abound	abounded	abounding	abounds
absenteeism
abstract	abstracts	abstracted	abstracting
abstraction	abstractions
abundance
academic	academics
accessory	accessories
acclimatise
accommodation	accommodations
accountancy
accredit	accredited	accrediting	accredits
accreditation
accumulate	accumulates	accumulating	accumulated
accustom	accustomed	accustoming	accustoms
acoustic	acoustics
acquaintance	acquaintances
acquisition	acquisitions
acrobatic
acumen
acupuncture
adaptation	adaptations
addition	additions
additional
adequate
adhere	adhered	adhering	adheres
adjacent
adjunct	adjuncts
administrative
administrator	administrators
adobe	adobes
adolescent	adolescents
advantageous
Advent	advents
adverse
advertise	advertised	advertising	advertises
advertisement	advertisements
advisable
aeration
aerobics
aeronautics
aerospace
aesthetic	aesthetics
affluent	affluents
afield
agenda	agendas
aggravation	aggravations
aggressiveness
agriculture
ailment	ailments
airtight	airtights
albeit
alchemist	alchemists
alienation
alight	alights	alighting	alighted
allege	alleged	alleging	alleges
allergic
alleviate	alleviated	alleviating	alleviates
allocate	allocates	allocating	allocated
allocation	allocations
allure	allures	allured	alluring
alluvial
almond	almonds
altitude	altitudes
altruistic
aluminium
ambiguity	ambiguities
ambiguous
ambitious
amorphous
amphibious
amplify	amplifies	amplifying	amplified
analogous
analogy	analogies
analyse	analyses	analysing	analysed
ancestral
anchor	anchors	anchoring	anchored
anecdotal
anthropologist
anticipate	anticipates	anticipating	anticipated
antiquated
antiquity	antiquities
antiseptic	antiseptics
apace
apparatus	apparatuses
appetite	appetites
appliance	appliances
application	applications
appoint	appointed	appointing	appoints
apportion	apportioned	apportioning	apportions
appraisal	appraisals
approximate	approximates	approximating	approximated
APT
aptitude	aptitudes
arable
arboreal
architect	architects
architecture
archive	archives	archiving	archived
aridity
arithmetic
arousal
array	arrays	arrayed	arraying
arrogance
artefact	artefacts
artery	arteries
arthritis
ascend	ascended	ascending	ascends
ascribe	ascribed	ascribing	ascribes
aspiration	aspirations
aspire	aspired	aspiring	aspires
assimilation
assistantship	assistantships
assumption	assumptions
assurance	assurances
astrology
astronomy
asymmetry
atmospheric
atomic
attain	attains	attaining	attained
attainable
attribute	attributed	attributing	attributes
audacious
audio
auditorium	auditoriums
augment	augmented	augmenting	augments
authenticate	authenticates	authenticating	authenticated
authorise
autocratic
autoimmune
autonomy
avail	availed	availing	avails
availability
aviation
bachelor	bachelors
backbone	backbones
bacterial
badminton	badmintons
Bamboo	bamboos
bankruptcy	bankruptcies
barbecue	barbecues	barbecuing	barbecued
baron	barons
barrage	barrages	barraged	barraging
barren	barrens
batch	batches	batching	batched
beehive	beehives
beforehand
begrime	begrimed	begriming	begrimes
begrudge	begrudges	begrudging	begrudged
beneficial
benevolent
bereave	bereaved	bereaving	bereaves
biased
bibliography	bibliographies
bilateral
bilingual	bilinguals
binoculars
biodiversity
biography	biographies
biological	biologicals
biometrics
bistro	bistros
blaze	blazed	blazing	blazes
bloom	blooms	blooming	bloomed
boast	boasts	boasting	boasted
bolster	bolsters	bolstering	bolstered
bookrest	bookrests
booming
bouncing
brass	brasses
brazen
breakthrough	breakthroughs
breakwater	breakwaters
brittle	brittler	brittlest
bronchitis
brood	broods	brooding	brooded
brunt	brunts
Budget	budgets	budgeting	budgeted
Buffalo	buffaloes	buffaloed	buffaloing
bulb	bulbs
bungalow	bungalows
bureaucracy	bureaucracies
burgeon	burgeoned	burgeoning	burgeons
burrow	burrows	burrowing	burrowed
bypass	bypasses	bypassed	bypassing
calcium
calibrate	calibrates	calibrating	calibrated
calibre	calibres
Calorie	calories
cameral
camouflage	camouflages	camouflaging	camouflaged
campfire	campfires
campus	campuses
canteen	canteens
Cantonese
capacity	capacities
capsize	capsizing	capsized	capsizes
cardiovascular
cascade	cascades	cascading	cascaded
catalogue	catalogues	cataloguing	catalogued
catastrophic
cater	caters	catering	catered
caustic	caustics
caution	cautions	cautioning	cautioned
cavort	cavorted	cavorting	cavorts
celestial
censure	censuring	censured	censures
centennial	centennials
centigrade
centrifugal	centrifugals
ceramic	ceramics
cereal	cereals
cervical
chancellor	chancellors
chapel	chapels
characteristic	characteristics
charter	charters	chartering	chartered
check-up	check-ups
chink	chinks	chinking	chinked
chorus	choruses	chorusing	chorused
chunk	chunks
cinematography
circulation	circulations
circumscribe	circumscribed	circumscribing	circumscribes
clamp	clamps	clamping	clamped
clarity
classical
classification	classifications
clench	clenches	clenching	clenched
clerk	clerks	clerking	clerked
climatic
clinical
cloakroom	cloakrooms
clockwise
clot	clotting	clotted	clots
coarse	coarser	coarsest
coffer	coffers	coffered	coffering
cognition
coherent
cohesion
coincide	coincides	coinciding	coincided
collaboration	collaborations
collate	collated	collating	collates
collection	collections
colour-blind
column	columns
comet	comets
commencement	commencements
commentary	commentaries
commerce
commiserate	commiserates	commiserating	commiserated
Commonwealth	commonwealths
commute	commutes	commuting	commuted
compact	compacted	compacting	compacts
comparable
comparative	comparatives
comparatively
compass	compasses	compassing	compassed
compatible
compatriot	compatriots
compendium	compendiums
compensation	compensations
complementary
compliment	compliments	complimented	complimenting
component	components
compose	composes	composing	composed
composition	compositions
comprehension	comprehensions
comprehensive	comprehensives
compress	compresses	compressing	compressed
comprise	comprises	comprising	comprised
compulsively
compulsory	compulsories
computerize	computerized	computerizing	computerizes
conceive	conceives	conceiving	conceived
conceptual
concession	concessions
concur	concurred	concurring	concurs
condemn	condemns	condemning	condemned
condensation
condense	condenses	condensing	condensed
conduce	conduced	conducing	conduces
conductive
configuration	configurations
conformity
congested
congestion
Congress	congresses
conjunction	conjunctions
consecutive
consensus
consequent	consequents
consequential
consequently
conservation
conserve	conserved	conserving	conserves
consideration	considerations
consignment	consignments
consistent
consolidation	consolidations
consortium	consortiums
constituent	constituents
constitute	constituted	constituting	constitutes
constrain	constrains	constraining	constrained
construct	constructs	constructing	constructed
Consulate	consulates
consultant	consultants
consumption
contemplate	contemplated	contemplating	contemplates
contemporary	contemporaries
continent	continents
contingency	contingencies
continually
continuity	continuities
continuous
contradict	contradicted	contradicting	contradicts
contradiction	contradictions
contrive	contrived	contriving	contrives
contrived
controversy	controversies
convection
conventional
converse	conversing	conversed	converses
conversely
conversion	conversions
convey	conveyed	conveying	conveys
conviction	convictions
cookery	cookeries
cooperative	cooperatives
coordinate	coordinated	coordinating	coordinates
cork	corks	corking	corked
corporal	corporals
corps
corpus	corpora
correlation	correlations
correspond	corresponds	corresponding	corresponded
correspondence	correspondences
corrode	corroded	corroding	corrodes
cosmic
cosmopolitan	cosmopolitans
cosset	cossets	cosseting	cosseted
cosy	cosier	cosiest	cosies
counsellor	counsellors
counterpart	counterparts
counterproductive
courtship	courtships
coverage
crescent	crescents
cricket	crickets
crisp	crisper	crispest	crisps	crisping	crisped
criteria	criterion
critic	critics
criticise
crockery
crossword	crosswords
crucial
crude	cruder	crudest
crystallize	crystallized	crystallizing	crystallizes
cuisine	cuisines
culminate	culminates	culminating	culminated
cultivation
curative	curatives
Curry	curries	currying	curried
curtail	curtails	curtailing	curtailed
cylinder	cylinders
darkroom	darkrooms
dazzle	dazzles	dazzling	dazzled
Dean	deans
dearth
debris
decibel	decibels
decipher	deciphers	deciphering	deciphered
decisive
decompression
decouple	decouples	decoupling	decoupled
decrepit
deem	deeming	deemed	deems
defence	defences
deflect	deflected	deflecting	deflects
degenerate	degenerating	degenerated	degenerates
delegate	delegates	delegating	delegated
deliberate	deliberates	deliberating	deliberated
delinquency	delinquencies
delinquent	delinquents
demerit	demerits
demographic	demographics
demonstration	demonstrations
denote	denotes	denoting	denoted
dense	denser	densest
density	densities
departmental
departure	departures
depletion
desirable	desirables
despite
despoil	despoils	despoiling	despoiled
detach	detaches	detaching	detached
deter	deterred	deterring	deters
deteriorate	deteriorated	deteriorating	deteriorates
deterioration
detour	detours	detouring	detoured
detrimental
devalue	devalued	devaluing	devalues
deviance
devise	devised	devising	devises
dictation	dictations
diesel	diesels
dietary
differentiate	differentiated	differentiating	differentiates
diffuse	diffused	diffusing	diffuses
digestive	digestives
dimension	dimensions	dimensioning	dimensioned
diminish	diminished	diminishing	diminishes
dioxide	dioxides
diploma	diplomas
directory	directories
disadvantage	disadvantages	disadvantaging	disadvantaged
disapprove	disapproved	disapproving	disapproves
disastrous
disclose	discloses	disclosing	disclosed
discourage	discourages	discouraging	discouraged
discourteous
discretion
disdain	disdained	disdaining	disdains
disempower	disempowers	disempowering	disempowered
disenchantment
disharmony
disillusionment
disintegrate	disintegrates	disintegrating	disintegrated
dismantle	dismantled	dismantling	dismantles
disorientate	disorientates	disorientating	disorientated
disparage	disparages	disparaging	disparaged
dispersal	dispersals
dispiriting
displace	displaced	displacing	displaces
disposable	disposables
dispute	disputes	disputing	disputed
disregard	disregards	disregarding	disregarded
disruption	disruptions
disruptive
dissatisfied
disseminate	disseminates	disseminating	disseminated
dissemination
dissertation	dissertations
distortion	distortions
diverge	diverges	diverging	diverged
diversify	diversified	diversifying	diversifies
dividend	dividends
divisional
dizziness
doctoral
doctorate	doctorates
documentation
dome	domes	domed	doming
domesticate	domesticated	domesticating	domesticates
donation	donations
dorm	dorms
dormancy
dormitory	dormitories
downpour	downpours
downsize	downsizing	downsized	downsizes
draft	drafts	drafting	drafted
draw back	draws back	drawing back	drew back	drawn back
dredge	dredges	dredging	dredged
droplet	droplets
drought	droughts
dubious
dupe	duping	duped	dupes
duplicate	duplicates	duplicating	duplicated
durable
duration	durations
dusk	dusked	dusking	dusks
dwell	dwells	dwelling	dwelled
dweller	dwellers
earthquake	earthquakes
earthwork	earthworks
earthworm	earthworms
easy-going
eccentric	eccentrics
ecliptic
eco-friendly
ecology	ecologies
economical
edify	edifies	edifying	edified
efficiency	efficiencies
efficient
eject	ejects	ejecting	ejected
ejection
elaboration
elastic	elastics
elicitation
eligible	eligibles
elucidate	elucidated	elucidating	elucidates
elusive
embankment	embankments
embed	embeds	embedding	embedded
embezzlement
embody	embodies	embodying	embodied
emboss	embosses	embossing	embossed
embryo	embryos
emeritus	emeriti
eminent
emit	emits	emitting	emitted
emperor	emperors
emphasis	emphases
emphasize	emphasizes	emphasizing	emphasized
empirical
enable	enables	enabling	enabled
enact	enacts	enacting	enacted
encapsulate	encapsulated	encapsulating	encapsulates
encase	encased	encasing	encases
enclosure	enclosures
encode	encodes	encoding	encoded
encompass	encompasses	encompassing	encompassed
encroach	encroaches	encroaching	encroached
endeavour	endeavours	endeavouring	endeavoured
endorse	endorsed	endorsing	endorses
energetic
enfranchise	enfranchises	enfranchising	enfranchised
engrave	engraves	engraving	engraved
engross	engrosses	engrossing	engrossed
enhancer
enigma	enigmas
enlarge	enlarges	enlarging	enlarged
enlist	enlisted	enlisting	enlists
enquire	enquires	enquiring	enquired
enquiry	enquiries
enrolment	enrolments
enslave	enslaves	enslaving	enslaved
entail	entails	entailing	entailed
entrepreneur	entrepreneurs
entrust	entrusts	entrusting	entrusted
entwine	entwines	entwining	entwined
envisage	envisages	envisaging	envisaged
episodic
epitomise
equation	equations
equator	equators
equity	equities
equivalent	equivalents
erode	erodes	eroding	eroded
erosion
erroneous
eruption	eruptions
essence	essences
esteem	esteemed	esteeming	esteems
estrange	estranges	estranging	estranged
estuary	estuaries
ethereal
evaluate	evaluates	evaluating	evaluated
evoke	evoked	evoking	evokes
exacerbate	exacerbated	exacerbating	exacerbates
exaggerate	exaggerates	exaggerating	exaggerated
excavate	excavated	excavating	excavates
excavation	excavations
exceed	exceeded	exceeding	exceeds
exceptional
excessive
exclusively
excreta
excursion	excursions
excusable
exemplify	exemplified	exemplifying	exemplifies
exhale	exhales	exhaling	exhaled
exhaustible
exhaustion
exhaustive
exhilaration
exile	exiles	exiling	exiled
exodus	exoduses
exorbitant
expansion	expansions
expectancy	expectancies
expedition	expeditions
expiry
exploitation
exploitative
exploratory
exposure	exposures
extendable
extension	extensions
extensive
externally
extinguisher	extinguishers
extol	extolled	extolling	extols
extract	extracts	extracting	extracted
extraordinary
extravagance	extravagances
extrovert	extroverts
extrusion	extrusions
exuberant
fabrication	fabrications
facade	facades
facilitate	facilitates	facilitating	facilitated
facsimile	facsimiles	facsimiled	facsimileing
factual
faculty	faculties
fallow
familiarise
fare	fares	faring	fared
fatal	fatals
fatigue	fatigues	fatiguing	fatigued
faulty	faultier	faultiest
fauna	faunas
favour	favours	favouring	favoured
feasible
feedback
ferry	ferried	ferrying	ferries
fertilize	fertilized	fertilizing	fertilizes
fieldwork	fieldworks
finite
finitude
fitness
flask	flasks
flexibility
flexible
flextime
flint	flints
fluctuate	fluctuates	fluctuating	fluctuated
fluctuation	fluctuations
fluency
flutter	flutters	fluttering	fluttered
forecast	forecasts	forecasting
foreland	forelands
foreseeable
formal	formals
formality	formalities
format	formats	formatting	formatted
formidable
formulation	formulations
Forth
forthcoming
forum	forums
fossil	fossils
foster	fostered	fostering	fosters
fragment	fragments	fragmented	fragmenting
fragrance	fragrances
fraught
freefone
freight	freights	freighting	freighted
frequent	frequents	frequenting	frequented
friction	frictions
frock	frocks	frocking	frocked
front-line
frontier	frontiers
frustration	frustrations
fulfillment	fulfillments
fumes
furnish	furnishes	furnishing	furnished
gadget	gadgets
gallery	galleries
gauge	gauges	gauged	gauging
gelatin	gelatins
generalise
generative
generic	generics
genuine
geographical
geological
geometric
geometry	geometries
germinate	germinated	germinating	germinates
glacial	glacials
gleam	gleamed	gleaming	gleams
gloss	glosses	glossing	glossed
glossary	glossaries
glossy	glossier	glossiest	glossies
glutamate	glutamates
Goal	goals
Goodwill
gorge	gorges	gorged	gorging
govern	governs	governing	governed
granite	granites
graphology
grasp	grasps	grasping	grasped
grassy	grassier	grassiest
gravel	graveled	graveling	gravels
gravity
gregarious
grid	grids
grieve	grieved	grieving	grieves
grim	grimmer	grimmest
grimy	grimier	grimiest
grin	grins	grinned	grinning
grope	gropes	groping	groped
grudge	grudges	grudged	grudging
guideline	guidelines
gullibly
guzzle	guzzling	guzzled	guzzles
habitable
habitual
hallowed
halve	halves	halving	halved
hamper	hampers	hampering	hampered
handout	handouts
haphazard
harness	harnesses	harnessing	harnessed
harridan	harridans
hasty	hastier	hastiest
hatch	hatches	hatching	hatched
hawk	hawked	hawking	hawks
hazardous
headmaster	headmasters
heap	heaps	heaping	heaped
hectare	hectares
helix	helixes
hemisphere	hemispheres
hence
herbal	herbals
herbivore	herbivores
herdsman	herdsmen
heritage	heritages
hesitate	hesitates	hesitating	hesitated
hesitation	hesitations
hiccup	hiccups	hiccupping	hiccupped
high-tech
highland
highlight	highlights	highlighting	highlighted
hinge	hinges
hinterland	hinterlands
hitherto
holistically
homesick
homestay	homestays
homogeneous
horizon	horizons
horizontal	horizontals
horrify	horrified	horrifying	horrifies
hospitable
hospitality
hostel	hostels
hostility	hostilities
household	households
hover	hovers	hovering	hovered
huddle	huddles	huddling	huddled
humane
humanistic
humid
humidity
hurl	hurled	hurling	hurls
hypnotic	hypnotics
hypothesis	hypotheses
hypothetical
identifiable
identification	identifications
illuminate	illuminates	illuminating	illuminated
illustration	illustrations
imitate	imitates	imitating	imitated
imitation	imitations
immense
impair	impaired	impairing	impairs
impart	imparted	imparting	imparts
imperil	imperiled	imperiling	imperils	imperilled
impetus
implication	implications
impoverish	impoverishes	impoverishing	impoverished
impoverished
imprecise
inactive
inadequate
inalienable
inaugurate	inaugurated	inaugurating	inaugurates
inborn
incapacitate	incapacitated	incapacitating	incapacitates
Incentive	incentives
incinerate	incinerates	incinerating	incinerated
inclination	inclinations
inclusive
incoming	incomings
incompatible
incongruous
incorporate	incorporates	incorporating	incorporated
inculcate	inculcates	inculcating	inculcated
indication	indications
indigenous
indispensable	indispensables
indolent
induce	induces	inducing	induced
induction	inductions
inductive
indulge	indulged	indulging	indulges
industrialise
industrious
inescapable
infer	infers	inferring	inferred
inference	inferences
inferential
infirmity	infirmities
inflammable	inflammables
inflation
influenza	influenzas
informant	informants
infrastructure	infrastructures
infringe	infringes	infringing	infringed
ingenuity
inhale	inhaled	inhaling	inhales
inhibit	inhibits	inhibiting	inhibited
inland
inlet	inlets	inleting
innovative
inscribe	inscribed	inscribing	inscribes
insidious
instil	instils	instilling	instilled
instinctual
institute	institutes	instituting	instituted
instrumental	instrumentals
insufficient
insularity
insulate	insulates	insulating	insulated
insulation
intake	intakes
integral	integrals
intelligible
intense
intensity	intensities
intent
interdependent
interface	interfaces	interfaced	interfacing
intermediate	intermediates	intermediated	intermediating
intermix	intermixing	intermixed
internationalist	internationalists
internist	internists
internship	internships
interplay
interpret	interprets	interpreting	interpreted
interpretation	interpretations
interrelationship	interrelationships
intrigue	intrigues	intriguing	intrigued
intrinsic
introspection
introvert	introverts	introverted	introverting
inundate	inundates	inundating	inundated
invalid	invalids	invaliding	invalided
invaluable
invasive
inversion	inversions
invert	inverts	inverting	inverted
inviolable
invisible	invisibles
invoke	invoked	invoking	invokes
ion	ions
iris	irises
irregularity	irregularities
irrelevant
irresistible
irrevocable
irrigation
irritate	irritated	irritating	irritates
irritation	irritations
isle	isles
itinerary	itineraries
jostle	jostled	jostling	jostles
journalist	journalists
journal	journals
judicious
jumble	jumbles	jumbling	jumbled
keystone	keystones
kneel	knelt	kneeling	kneels
knob	knobs	knobbing	knobbed
labour	labours	labouring	laboured
lag	lagged	lagging	lags
landfill	landfills
landmark	landmarks
landscape	landscapes	landscaping	landscaped
landward
large-scale
larva	larvae
latent
lateral	laterals	lateraled	lateraling
laterality
latitude	latitudes
lavatory	lavatories
LAX	laxer	laxest
layout	layouts
leaflet	leaflets	leafleting	leafleted
lease	leases	leasing	leased
legacy	legacies
legislative
legitimacy
legitimize	legitimizes	legitimizing	legitimized
leisure
lenient
lethal
leukaemia
lexicographer
liaise	liaises	liaising	liaised
libel	libels	libelling	libelled
liberty	liberties
likelihood
lime	limes	liming	limed
limestone	limestones
limitation	limitations
linguistic
literacy
literature
livestock
loath
locality	localities
long-term
longitude	longitudes
longitudinal
loop	loops	looping	looped
lull	lulls	lulling	lulled
luxuriant
machinery
magma	magmas
magnificent
mainly
mainstream	mainstreams	mainstreaming	mainstreamed
malevolent
malleable
malt	malts	malting	malted
maltreat	maltreats	maltreating	maltreated
managerial
Mandarin	mandarins
maneuver	maneuvers	maneuvering	maneuvered
manor	manors
manufacture	manufactures	manufacturing	manufactured
manufacturer	manufacturers
margin	margins	margined	margining
marginally
maritime
marketplace	marketplaces
marsupial	marsupials
marvellous
master card
mastery
maternal
maximise
meagre
medication	medications
medieval
mediocre
mediterranean	mediterraneans
megacity
melatonin
membership	memberships
memorable
memorandum	memorandums
memorize	memorizes	memorizing	memorized
mentor	mentors	mentored	mentoring
merchandising
mercury
mere	merest	meres
metaphorical
microbiology
microcosm	microcosms
microprocessor	microprocessors
migrant	migrants
migrate	migrated	migrating	migrates
migration	migrations
migratory
milestone	milestones
militant	militants
mime	mimes	miming	mimed
mineral	minerals
mingle	mingled	mingling	mingles
minimal
minimise
ministry	ministries
miscellaneous
misconception	misconceptions
mishandle	mishandled	mishandling	mishandles
misjudge	misjudging	misjudged	misjudges
mite	mites
modem	modems
moderate	moderates	moderated	moderating
moderately
modernism	modernisms
modification	modifications
modish
module	modules
molecule	molecules
momentum	momenta
monopoly	monopolies
monotonous
monumental
moribund
moss	mosses
mould	moulds	moulding	moulded
muddle	muddles	muddling	muddled
mundane
municipal	municipals
murky	murkier	murkiest
mushroom	mushrooms	mushroomed	mushrooming
narrator	narrators
nationality	nationalities
navigable
necessity	necessities
neglect	neglected	neglecting	neglects
neoclassical
nevertheless
newsletter	newsletters
niggle	niggled	niggling	niggles
nocturnal
Nordic	nordics
notable	notables
notify	notifies	notifying	notified
notion	notions
notoriety
nourish	nourishes	nourishing	nourished
novice	novices
nursery	nurseries
nutritional
nutritious
objective	objectives
obscene
obscurity	obscurities
observation	observations
obstruct	obstructed	obstructing	obstructs
occasion	occasions	occasioning	occasioned
occasionally
odour	odours
offset	offsets	offsetting
onslaught	onslaughts
onwards
opaque	opaques
operational
optic	optics
optimistic
optimum	optima
optional
optometrist	optometrists
opulence
opulent
organic	organics
orientate	orientates	orientating	orientated
originate	originated	originating	originates
ornament	ornaments	ornamented	ornamenting
ornamental	ornamentals
orthodox	orthodoxes
Outlook	outlooks
outpost	outposts
outsell	outsells	outselling	outsold
outward
overdraft	overdrafts
overestimate	overestimates	overestimating	overestimated
overexploit
overfill	overfills	overfilling	overfilled
overgraze
overhead	overheads
overlap	overlaps	overlapping	overlapped
overlap	overlaps	overlapping	overlapped
overlie	overlay	overlain	overlying	overlies
overrate	overrated	overrating	overrates
oversee	oversaw	overseen	overseeing	oversees
overshadow	overshadows	overshadowing	overshadowed
overview	overviews
oxide
painstaking
pamper	pampers	pampering	pampered
paralysis
paramount
parcel	parcels	parceled	parceling
Parliament	parliaments
partial
participant	participants
particularly
particulate
passionate
pasture	pastures	pastured	pasturing
pathology
pathway	pathways
patriotic
patronage
payable
pearl	pearls	pearled	pearling
pedigree	pedigrees
penalize	penalizes	penalizing	penalized
pension	pensions	pensioned	pensioning
perception	perceptions
periodical	periodicals
periphery	peripheries
permeate	permeates	permeating	permeated
perpetrate	perpetrated	perpetrating	perpetrates
perpetual
perpetuate	perpetuated	perpetuating	perpetuates
perplex	perplexed	perplexing	perplexes
perquisite	perquisites
persist	persisted	persisting	persists
personalize	personalizes	personalizing	personalized
personnel
pervasive
pesticide	pesticides
petrol
petroleum
photocopy	photocopies	photocopying	photocopied
physician	physicians
picturesque
plagiarise
plagiarism	plagiarisms
plateau	plateaus	plateauing	plateaued	plateaux
plausible
pliable
plough	ploughs	ploughing	ploughed
plush	plusher	plushest
pollinate	pollinated	pollinating	pollinates
pollutant	pollutants
populace
popularize	popularized	popularizing	popularizes
populate	populated	populating	populates
pore	pored	poring	pores
portable	portables
post-mortem
postcode	postcodes
postgraduate	postgraduates
poultry
pragmatic
precarious
precede	preceded	preceding	precedes
precipitation
precise
precision
predatory
predispose	predisposed	predisposing	predisposes
predominant
predominantly
predominate	predominated	predominating	predominates
prefabricate	prefabricated	prefabricating	prefabricates
preface	prefaces	prefacing	prefaced
preferable
preliminary	preliminaries
premier	premiers
premise	premises	premised	premising
premium	premiums
prerequisite	prerequisites
presumably
presuppose	presupposes	presupposing	presupposed
pretension	pretensions	pretensioned	pretensioning
pretentious
prevalence
prevalent
preventative
prior	priors
probation
procession	processions
proclaim	proclaims	proclaiming	proclaimed
procrastinate	procrastinates	procrastinating	procrastinated
productivity
prohibit	prohibited	prohibiting	prohibits
prohibitive
prolonged
prominence	prominences
promotion	promotions
pronounceable
propagate	propagated	propagating	propagates
propel	propels	propelling	propelled
propellant	propellants
proposal	proposals
propose	proposes	proposing	proposed
prospective
prospectus	prospectuses
prosperous
protrude	protrudes	protruding	protruded
provenance	provenances
prowess
proximity
pulley	pulleys
pulverise
pumice	pumices
punctual
qualitative
quartz
questionnaire	questionnaires
quiver	quivered	quivering	quivers
quota	quotas
radiate	radiates	radiating	radiated
rarity	rarities
ratio	ratios
recalcitrant	recalcitrants
recapture	recaptures	recapturing	recaptured
receiver	receivers
reception	receptions
receptionist	receptionists
recession	recessions
recipient	recipients
reciprocate	reciprocates	reciprocating	reciprocated
recommendation	recommendations
recreate	recreated	recreating	recreates
recreation	recreations
recreational
rectangle	rectangles
rectangular
redevelopment
redundant
refectory	refectories
referee	referees	refereeing	refereed
refinement	refinements
refresh	refreshes	refreshing	refreshed
refresher	refreshers
refundable
regent	regents
regularity
regulate	regulates	regulating	regulated
regurgitate	regurgitates	regurgitating	regurgitated
reinforce	reinforces	reinforcing	reinforced
reinvigorate
reiterate	reiterated	reiterating	reiterates
relentless
reliable
reliance	reliances
remuneration	remunerations
renaissance	renaissances
renew	renews	renewing	renewed
renewable
renewal	renewals
rental	rentals
reorient	reoriented	reorienting	reorients
repack
repaint
repatriate	repatriated	repatriating	repatriates
repel	repels	repelling	repelled
repertoire	repertoires
replenish	replenished	replenishing	replenishes
representative	representatives
reptile	reptiles
reputable
requirement	requirements
requisite	requisites
requisition	requisitions	requisitioning	requisitioned
resemble	resembles	resembling	resembled
resign	resigned	resigning	resigns
resilience
resit	resits	resitting	resat
respondent	respondents
restrict	restricts	restricting	restricted
restriction	restrictions
retailer	retailers
retailing
retrenchment
revegetate	revegetated	revegetating	revegetates
Revelation	revelations
rigid
rigorous
ritual	rituals
robotic
robust
rotate	rotated	rotating	rotates
rude	ruder	rudest
rudimentary
rural
ruthless
saline
salinity
sanctuary	sanctuaries
sanitary
sanitation
savour	savours	savouring	savoured
scamper	scampers	scampering	scampered
scandal	scandals
scenery
sceptical
scope	scopes	scoping	scoped
scorching
scour	scours	scouring	scoured
scrupulous
scuffle	scuffles	scuffled	scuffling
seasonal
secondary	secondaries
sedentary
seep	seeped	seeping	seeps
segment	segments	segmenting	segmented
segregate	segregated	segregating	segregates
self-esteem
semantic
sensational
sensible
sensory
shareholder	shareholders
sharpen	sharpened	sharpening	sharpens
sheer	sheered	sheering	sheers
shilling	shillings
shin	shins	shinned	shinning
short-term
shorthand	shorthands
shrewd	shrewder	shrewdest
shrub	shrubs
shrug	shrugs	shrugging	shrugged
siesta	siestas
sift	sifts	sifting	sifted
signpost	signposts	signposted	signposting
silt	silted	silting	silts
similarly
simplicity	simplicities
simplify	simplifies	simplifying	simplified
simplistic
simultaneous	simultaneouses
simultaneously
sincere	sincerer	sincerest
situated
sizeable
skew	skews	skewing	skewed
skyscraper	skyscrapers
slacken	slackens	slackening	slackened
slat	slats	slatted	slatting
sledge	sledges	sledged	sledging
slender	slenderer	slenderest
sliver	slivers	slivering	slivered
slothful
slouch	slouches	slouching	slouched
slum	slums	slumming	slummed
slump	slumps	slumping	slumped
slurry
sluttish
snobbish
sociable
socialise
sociology
solar-powered
sole	soles	soled	soling
solemn
solicitor	solicitors
solidarity
solidify	solidified	solidifying	solidifies
soluble
spacious
span	spans	spanned	spanning
spasm	spasms
spasmodic
specialise
specialty	specialties
specification	specifications
Spectator	spectators
spectrum	spectra
sphere	spheres	sphered	sphering
spite	spites	spiting	spited
splint	splints	splinting	splinted
spoilage
sporadically
sprawl	sprawls	sprawling	sprawled
spur	spurs	spurred	spurring
stabilise
stagnate	stagnates	stagnating	stagnated
stainless
staircase	staircases
stammer	stammers	stammering	stammered
starchy	starchier	starchiest
stark	starker	starkest
stationary
stationery
statistic	statistics
statistics
stereo	stereos
stereoscopic
stimulus	stimuli
stipulate	stipulated	stipulating	stipulates
stockpile	stockpiled	stockpiling	stockpiles
storey	storeys
stout	stouter	stoutest	stouts
stove	stoves	stoved	stoving
strategist	strategists
stringent
studious
stylish
subjective
submerge	submerged	submerging	submerges
subordinate	subordinates	subordinated	subordinating
subscribe	subscribes	subscribing	subscribed
subsequent
subsidiary	subsidiaries
subsidise
subsidy	subsidies
subsoil	subsoils	subsoiled	subsoiling
substance	substances
substitution	substitutions
subtract	subtracts	subtracting	subtracted
subtropical
suburb	suburbs
succession	successions
successive
succumb	succumbed	succumbing	succumbs
suitably
sulphuric
summarise
summary	summaries
sundial	sundials
superb
superficial
supersede	supersedes	superseding	superseded
superstitious
supervision
supervisor	supervisors
supplement	supplements	supplemented	supplementing
supplementary	supplementaries
suppression
surge	surges	surging	surged
surroundings
susceptible
sustain	sustains	sustaining	sustained
sustainable
sympathise
sympathy	sympathies
symphony	symphonies
synchronise
synthesis	syntheses
synthetic	synthetics
systematic
tangibly
tariff	tariffs	tariffed	tariffing
taunt	taunts	taunting	taunted
technician	technicians
tedious
teem	teemed	teeming	teems
telegraph	telegraphs	telegraphing	telegraphed
telescope	telescopes	telescoping	telescoped
tenable
tendency	tendencies
tense	tenses	tenser	tensest	tensing	tensed
tensile
terminology	terminologies
terrace	terraces	terracing	terraced
terrain	terrains
terrestrial	terrestrials
textile	textiles
thereby
thermal	thermals
thesis	theses
thorny	thornier	thorniest
thoughtful
threshold	thresholds
thrifty	thriftier	thriftiest
tighten	tightened	tightening	tightens
tillable
tilt	tilts	tilting	tilted
topple	toppled	toppling	topples
topsoil	topsoiled	topsoiling	topsoils
torrent	torrents
tortoise	tortoises
townscape	townscapes
tram	trams	tramming	trammed
tramp	tramps	tramping	tramped
tranquility
transcend	transcends	transcending	transcended
transcribe	transcribes	transcribing	transcribed
transcript	transcripts
transcription	transcriptions
transit	transits	transiting	transited
transition	transitions	transitioned	transitioning
transmute	transmutes	transmuting	transmuted
transparent
transport	transports	transporting	transported
trapeze	trapezes
treadmill	treadmills
treatise	treatises
tribal	tribally
tribute
trivialize	trivialization	trivialized	trivialized	trivializing	trivializes
tropospheric
truant	truanted	truanted	truanting	truants
trustworthy	trustworthily	trustworthier	trustworthiest	trustworthiness
turbid	turbidly	turbidness
turbine
turnover
turret
tutorial
twofold
ulterior	ulteriorly
ultraclean
unaware	unawarely	unawareness
unbeatable	unbeatably
unbiased	unbiasedly	unbiasedness
unblemished
unconcerned	unconcernedly	unconcernedness
unconquerable	unconquerably
undergraduate
underline	underlined	underlined	underlining	underlines
underling
underlying
underpin	underpinned	underpinned	underpinning	underpins
understandable
undertake	undertook	undertaken	undertaking	undertakes
undisguised
undoubtedly	undoubted
uneasy	uneasily	uneasier	uneasiest	unease
unemployment
unobtrusive	unobtrusively	unobtrusiveness
unparalleled
unprejudiced
unquote
unrealistic	unrealistically
unregistered
untrustworthy
unwrap	unwrapped	unwrapped	unwrapping	unwraps
up-to-date	up-to-dateness
uphill
urban
urbanization
utilise
utility	utilities
utilization
vacancy	vacancies
vacant	vacantly	vacantness
valid	validly	validity
variability	variabilities
variant
variation	variational
vary	varyingly	varied	varied	varying	varies
vegetation	vegetational
velocity	velocities
venomous	venomously	venomousness
venue
verify	verifier	verified	verified	verifying	verifies
vernacular	vernacularly
versatile	versatilely	versatility
vertebrate
vertical	vertically	verticality
vested
veterinary	veterinaries
viable	viably	viability
vibrant	vibrantly	vibrancy
vibrate	vibrated	vibrated	vibrating	vibrates
victimise
viewpoint
vigorous	vigorously	vigorousness
virtually
virtue
virtuous	virtuously	virtuousness
visa	visaed	visaed	visaing	visas
viscous	viscously	viscousness
visual	visually	visualness
vitality	vitalities
vivid	vividly	vivider	vividest	vividness
vocational	vocationally
volt
voltage
voluntary	voluntarily	voluntariness	voluntaries
voyage	voyager	voyaged	voyaged	voyaging	voyages
waist	waistless
wastage
water-borne
waterfront
waterproof	waterproofed	waterproofed	waterproofing	waterproofs
wean	weaned	weaned	weaning	weans
whereas
widespread
windscreen
withstand	withstander	withstood	withstood	withstanding	withstands
workforce
world-wide
worthwhile	worthwhileness
wretch
wrinkle	wrinkly	wrinkled	wrinkled	wrinkling	wrinkles
yield	yielder	yielded	yielded	yielding	yields
zoological	zoologically	zoologic
